R 1280 720
NO ./imgs/1.xpm
SO ./imgs/2.xpm
WE ./imgs/3.xpm
EA ./imgs/5.xpm
S ./imgs/sprite.xpm
F 101,67,145
C 101,67,145

11111111111111111111
10000000000000000001
12002002002002002001
12002002002002002001
12002002002002002001
12002002002002002001
12222220000002222221
12222220001002222221
12222220000002222221
1222222000W002222221
11111111111111111111